╔══════════════  
║               ║
║ ╔═══╗ ╔═════╗ ║
║ ║   ║ ║     ║ ║
║   ╔═╩═╝ ╔═╗ ║ ║
╚═══╝     ║ ╠═╝ ║
      ══╗ ║ ║   ║
╔═╗ ╔═══╝ ║ ║   ║
║ ║ ║     ║     ║
║ ║ ╚═╗ ╔═╝ ║   ║
║     ║ ║   ╩═══╝
╚═══╗ ║ ╚ ════╗
    ║         ║
════╩═╩═══════╝